###########
#~  ..$@..#############
#..   ........$  .@@ .#
#....@$...###### .   .#
#$$...@$.;#    #..$...#
###.#######    ########
  #.#
  # ######
  #  @   #
  #      #
  ########
